H..OH.HO
.O.O.O.O
.O.O.O.O
.O.O.O.O
.O.O.O.O
.O.O.O.O
.O.O.O.O
.O.O...O
.O.O.O.O
.O...OHT