H..OH.HO
.O.O.O.O
.O.O.O.O
.O.O.O.O
.O.O.O.O
.O.O.O.O
...O.O.O
.O.O.O.O
.O.O.O.O
.O.O.O.O
.O.O.O.O
.O..HO.O
.O.O.O.O
.OHO.O.O
.O.O.O.O
.O.O.O.O
.O.O.O.O
.O.O...O
.O.O.O.O
.O...OHT